width = 14, height = 14
        
	+---+---+---+---+---+---+---+---+---+---+---+---+---+---+
	|       |       |       |                   |   |       |
	+   +   +---+   +   +   +   +   +   +---+---+   +   +---+
	|   |       |       |       |   |   |                   |
	+---+   +---+   +---+   +   +---+   +---+   +   +   +---+
	|   |       |       |   |   |       |       |   |       |
	+   +---+   +---+---+   +---+---+   +---+   +   +---+---+
	|   |               |       |               |   |   |   |
	+   +---+---+---+   +   +---+   +   +---+   +   +   +   +
	|                           |   |   |       |           |
	+---+   +   +---+---+---+   +---+---+---+---+---+   +---+
	|       |               |   |       |   |       |       |
	+   +   +---+---+---+   +---+---+   +   +   +---+   +---+
	|   |               |   |   |   |   |                   |
	+   +   +   +---+---+   +   +   +   +---+---+   +---+   +
	|   |   |       |       |   |               |   |   |   |
	+---+   +---+---+---+---+   +---+   +---+   +   +   +---+
	|       |       |   |           |   |   |               |
	+---+   +   +---+   +   +   +   +   +   +   +   +---+---+
	|   |   |   |   |       |   |           |   |           |
	+   +   +   +   +   +---+   +---+   +---+---+---+---+   +
	|   |       |       |       |       |       |   |       |
	+   +   +---+   +   +   +---+---+---+---+   +   +   +---+
	|   |   |       |   |           |   |       |           |
	+   +   +---+   +---+   +   +   +   +   +---+---+   +---+
	|           |   |   |   |   |       |       |           |
	+---+---+   +---+   +   +---+   +---+   +   +   +---+---+
	|               |       |               |   |           |
	+---+---+---+---+---+---+---+---+---+---+---+---+---+---+

1001110010111100100111001001100010001010111011011001111001110001111000010110000101000111010110111000000000001110110100111100001111100101011110110100101101000101001111100101101100101010110000011110100100001010010001011101110100111000100010100010001011000111011110110110001100000110100101000011101010101100011110111100110110011110000111100101000110001010111001011101110101010011001010000010110001110101001111101011011001010011000010101100010111010111101101001001111011011001000011000101110100010000001011101101010101011101000101100101001100000110011100111010110001010001011000010100100101101011011010111100110110010110010101011011010001110001100011001101100101100011000011100011001011000111110101010111000101100001110010010010111010111010001011100011011010110010101001100111001110101110